15
7
030203656300000
030303636303000
030303636303333
000366636663000
333303333303060
333303333303060
333303333300060