10
7
3333200333
3333000333
5666666666
6333000336
6333333336
6333333336
6000000000